Language,Location,Filename,Lines,Code,Comments,Blanks,Complexity,Bytes
Java,src/main/java/com/uam/spaceinvaders/entities/Sandbag.java,Sandbag.java,42,29,0,13,0,792
Java,src/main/java/com/uam/spaceinvaders/entities/aliens/GreenAlien.java,GreenAlien.java,18,12,0,6,1,381
Java,src/main/java/com/uam/spaceinvaders/entities/aliens/Alien.java,Alien.java,132,94,0,38,8,2882
Java,src/main/java/com/uam/spaceinvaders/entities/projectiles/AlienProjectile.java,AlienProjectile.java,16,11,0,5,0,452
Java,src/main/java/com/uam/spaceinvaders/entities/aliens/RedAlien.java,RedAlien.java,18,12,0,6,1,377
Java,src/main/java/com/uam/spaceinvaders/audio/Audio.java,Audio.java,55,40,0,15,2,1331
Java,src/main/java/com/uam/spaceinvaders/entities/aliens/YellowAlien.java,YellowAlien.java,18,12,0,6,1,383
Java,src/main/java/com/uam/spaceinvaders/entities/projectiles/SpaceshipProjectile.java,SpaceshipProjectile.java,18,12,0,6,0,461
Java,src/main/java/com/uam/spaceinvaders/App.java,App.java,9,7,0,2,0,191
Java,src/main/java/com/uam/spaceinvaders/presentation/GamePanel.java,GamePanel.java,108,82,0,26,2,2204
Java,src/main/java/com/uam/spaceinvaders/entities/aliens/WhiteAlien.java,WhiteAlien.java,17,12,0,5,1,390
Java,src/main/java/com/uam/spaceinvaders/entities/projectiles/Projectile.java,Projectile.java,82,57,0,25,0,1682
Java,src/main/java/com/uam/spaceinvaders/entities/interfaces/MovableComponent.java,MovableComponent.java,15,8,0,7,0,210
Java,src/main/java/com/uam/spaceinvaders/presentation/GameFrame.java,GameFrame.java,50,38,0,12,0,1059
Java,src/main/java/com/uam/spaceinvaders/levels/LevelOne.java,LevelOne.java,98,66,0,32,10,2219
Java,src/main/java/com/uam/spaceinvaders/levels/Level.java,Level.java,179,129,0,50,9,3920
Java,src/main/java/com/uam/spaceinvaders/entities/Spaceship.java,Spaceship.java,272,200,0,72,17,5616
